1111111111111
1E000000000E1
100000C000001
1P000CCC00001
100000C000001
1E000000000E1
1111111111111
